      ####
 # ##   ##
 # #  #  #
 #   ### B
 ### ### #
A#       #